1 2 2 2 2 2 2 2 2 2 2 2 2 2 2 2 2 2 2 2 2 2 2 2 2 2 2 2 2 2 2 2 2 2 2 2 2 2 2 3
5 0 0 0 0 0 0 0 0 0 0 0 0 0 0 0 0 0 0 0 0 0 0 0 0 0 0 0 0 0 0 0 0 0 0 0 0 0 0 5
5 0 0 0 1 2 2 2 3 0 0 0 0 0 0 0 1 2 2 2 2 2 3 0 0 1 2 2 2 3 0 0 0 0 0 0 0 0 0 5
5 0 0 0 5 0 0 0 5 0 0 0 0 0 0 0 5 0 0 0 0 0 5 0 0 5 0 0 0 9 2 2 2 2 2 2 3 0 0 5
5 0 0 0 5 0 14 0 9 2 2 2 2 2 2 2 7 0 0 14 0 0 5 0 0 5 0 14 0 0 0 0 0 11 0 0 4 0 0 5
5 0 0 0 5 0 0 0 0 0 0 0 14 0 0 0 0 0 0 0 0 0 9 2 2 7 0 0 0 0 0 0 0 0 0 0 4 0 0 5
5 0 0 0 5 0 0 0 0 0 14 0 0 0 0 0 10 0 0 0 0 0 0 0 0 0 0 0 0 14 0 0 0 13 2 2 7 0 0 5
5 0 0 0 5 0 1 2 2 2 2 2 0 2 2 2 2 2 3 0 8 2 12 0 0 0 14 0 0 0 0 0 0 0 0 5 0 0 0 5
5 0 0 0 5 0 5 0 0 0 0 0 0 0 0 0 0 0 5 0 4 6 0 0 0 0 0 0 0 0 10 0 0 0 0 5 0 0 0 5
5 0 0 0 5 14 5 2 2 2 3 0 0 0 0 0 0 0 5 0 9 2 2 2 2 2 2 2 3 0 5 0 0 14 0 5 0 0 0 5
5 0 0 0 5 0 5 0 0 0 5 0 0 0 0 0 0 0 5 0 0 0 0 0 0 0 0 0 5 2 7 14 0 2 2 2 3 0 0 5
5 0 0 0 5 0 5 0 0 0 5 2 2 2 2 3 0 0 5 0 1 2 3 0 0 0 14 0 5 0 0 0 0 0 0 0 5 0 0 5
5 0 0 0 5 0 10 0 14 0 5 0 0 0 0 5 0 0 5 0 5 0 5 0 0 0 0 0 5 0 14 0 0 10 0 0 5 0 0 5
5 0 0 0 5 0 0 0 0 0 5 0 0 0 0 5 0 0 5 0 5 0 9 2 2 2 2 2 7 0 0 0 0 5 0 0 5 0 0 5
5 0 0 0 5 0 11 0 0 0 5 0 0 0 0 5 0 0 5 0 5 0 0 0 0 0 0 0 0 0 0 1 2 7 0 0 5 0 0 5
5 0 0 0 5 0 5 0 14 0 5 0 13 2 2 2 2 2 7 0 9 2 2 2 2 2 2 2 2 2 2 7 0 0 0 0 5 0 0 5
5 0 0 1 7 0 9 3 0 0 5 0 0 0 5 0 0 0 0 0 0 0 0 0 0 0 0 0 0 14 0 0 0 0 0 0 5 0 0 5
5 0 0 5 14 0 0 9 2 2 2 0 2 2 9 0 0 0 14 0 1 2 2 2 0 2 2 2 2 2 2 3 0 0 0 0 5 0 0 5
5 0 0 5 0 0 0 0 0 0 0 14 0 0 0 0 0 14 0 0 5 0 14 0 0 0 0 0 0 5 0 5 0 0 0 0 5 0 0 5
5 0 0 5 0 0 0 14 1 2 2 2 2 2 3 0 0 0 0 0 5 0 10 12 0 0 0 0 0 5 0 5 0 0 0 0 5 0 0 5
5 0 0 9 2 2 2 2 9 0 0 0 0 0 5 0 0 0 0 0 5 0 5 0 0 0 0 0 0 5 0 9 2 2 2 2 7 0 0 5
5 0 0 0 0 0 0 0 0 0 0 0 0 0 9 2 2 2 2 2 7 0 9 2 2 2 2 2 2 7 0 0 0 0 0 0 0 0 0 5
5 0 0 0 0 0 0 0 0 0 0 0 0 0 0 0 0 0 0 0 0 0 0 0 0 0 0 0 0 0 0 0 0 0 0 0 0 0 0 5
11 2 2 2 2 2 2 2 2 2 2 2 2 2 2 2 2 2 2 2 2 2 2 2 2 2 2 2 2 2 2 2 2 2 2 2 2 2 2 11